###########################################################################
#..#......#.....##.##..#.........#....#...#..#..#........#....#...........#
#..#.........#...#...#..#...#......##.................#..##...........#...#
#..#..#.#.......#.##.##.##....#.#....#.....#......#...#.................#.#
#......#..##....#.##..#........#.##.........#..#........#............#.#..#
#..#....#..#..#.................#........#....##......#...#..#.#...#...#..#
#.........#........#.#.....##.#.........#.....#...#.#............#.....#..#
#......#....#...#.............#....#.............#......##....#..##......##
#...#.....##.....................#..#.#....#...........#....#.......#....##
##..#..........#.........#..#.............#..#.##.......................#.#
##.......#............#.#.###......#....#.......#.......##..#.......#.....#
#.##........#.......#.....#..#...##.........................#...#......#..#
#.#.......#....#.##......#..#..#.#.......##...#.....#....#..#..#..........#
#...#........##......##........##.#..........#...............##.#..#.....##
#..........#..#...........#......#.........##..#........#..#.............##
#........#....#....#..#.#.#..#....#.##..........#.#.#......##.#...#.##....#
#.#......#.....#.....#.................#.........#.............#.#.....#..#
#.......#...#...#.###..#...##...#.#...........#...#.##.....#...#.......#..#
#...##........##..#...##..........#.......#..####....##.#.......#.#.......#
#...................#......#........#.#.....##..#..#.#..#......##..#....#.#
#...#.........#....#........#..#..#........###.#.#....#........#..........#
#....#....##.......#.#...................#....#.....#....#.......#.....#.##
##...##.............#...##.......#.#...#..#.............###...............#
##........#.#......#.....................##....#.#.....#...#...........#..#
#........#.#......#.#...##............#.#.....#...........#.....#.#.##....#
#..........#.#...#.#.#..##............##.#..........#......#.....#.##.#...#
#..#....................#..............#..............#........####.##....#
#....#......#..#...#.##.....#...#..#........#.#....#...#.............#....#
#..........#...#..............#....#...###...#.....#.....#....##...#......#
#.#....###...........#...##...####..#...#.............#.#..#....#.###.....#
#.....#.#......##..#....##.........#...#...#..##..#........##...........#.#
#....#......#...#....#.....#.#............#...#...#...##.#.#.....#..##....#
##.#.....#.....#.#.#....#..#..#....#..................#.#.#...........#...#
#.#........#.#..#.#..#...##.......#.......##.#..#.##...#...##...........#.#
#..#...............#....#...............#.......###....#.#.##...#..#.#...##
#....#.....#............#.#.##..#.#...##...#..#..#.#......#..##.........#.#
#.....#...#...........#..........#..#..#.#.....#.#.....#........#......#..#
#...........#..#....##.#.....#...#....#..#....#........##.#.........##.#..#
#...#..#.............................##..........#........#...#.##........#
#....##...###....#..#.#..#......................#.............#.#.........#
#..##...#.#.#......#.#.....#......#........#.....#...#.....#...#...##..#..#
#.....#........#.....#...#..#...#..##...#...##..........#.##....#.........#
#.............#...#...#....##...##......#...##...#....#....#...#..#....#..#
#.###.#..........#.#..#.......#................#.....#..#....#.#.#........#
#....##.#.....#........#...#.#.....#....#............#...#....##........###
##.....##....#............#...#........#...#................##..#.#...#...#
###..........#.#...#..#.#...........##...##..#.....#.##.........#.........#
#......#.#...#.#....#....#..........#.......................##.#..#..#....#
#.#...#.#.#...#........####....#.#......##....#..##............#.##.#...#.#
##....#..##.....#................#..........#.#.#..#...#....#..#..........#
#.##...............#....##.##...............##...#....#..#......#...#..#..#
#........#.##....#.##...#...##.......#........#..#.....#.##.##..#.....##.##
###..............#..#...........#..........#..............................#
#.....##..#..#...#....#.##..#.....##.#...............#..............##....#
#.#..##........#.#.#.##....##..#.#...#........#.##.#..#.......#...........#
#....#.##...#.........#....#....#......###..##..#..###.......#......#...#.#
#...................#...#.#......#.#......#......##.........#....#....#...#
#..##..........#...........#....##.##..#.....#.......#..#.#..#....#.......#
#....#...#..#.#..#.......#............#......#...#.............#..#.......#
#...##..#.....#..#...#.#....#..#.#.#.....#..........#......#..............#
#........#....##.#.##...#.##....#...........#.##.#.....#..#...#......#...##
#.#.....#...........#.#.#.#.....#....#.........#....#.##.........#..#.....#
###........#....##................#......#..........#.###..#........#.....#
#.....#.......#.....#.............#......##.....##....#.#.......##..#..#..#
#......#....#....#.....#..............#......#...#.........#.....##.......#
#.#........#..#..#.#....#..........#.#...#..##.#...#................#.....#
#......#.............#...#...##...........##........#.#...#...........#...#
###......####..#..#...........#......#.......###..........#..#....##......#
#.....#...#....#.#.#..#...##.....#........#...#.#........#..##......#.#...#
###..##........................#.#......#.#......##....#....#.....#.#.....#
#.#....#..#...#.....................#.........#....#........##...#........#
#..#...##....#....#.........#............#.......##...#..##.##....##..#...#
##.........#..#...###........#.#.#...........#.....#.......#..............#
#.#.#.......##.....#.........###....#......#..#...........#..#.#..........#
###########################################################################
